NO ./textures/wolfenstein/grey_stone.xpm   
                 SO ./textures/wolfenstein/grey_stone.xpm
          WE ./textures/wolfenstein/grey_stone.xpm
EA             ./textures/wolfenstein/grey_stone.xpm

C 1,   85  ,32
F 220, 255, 200

1111111111111111111111111
1010110000100000000000001
1010110000000000111111001
1010110000000000110001001
1010110000000000000000001
1010000000000000000000001
1000000000000000000000001
1000000000000000000000001
1000000000000000000N00001
1000000010000000000000001
1000000000000000000000001
1000000000000000000000001
1000000000000000000000001
1000000000000000000000001
1000000000000000000000001
1000000000000000000000N01
1111111111111111111111111