NO ./textures/wolfenstein/grey_stone.xpm   
SO ./textures/wolfenstein/grey_stone.xpm
WE ./textures/wolfenstein/grey_stone.xpm
EA ./textures/wolfenstein/grey_stone.xpm

C 0,   85  ,32
F 220, 255, 200


1111111111111111111111111
1000000000000000000000001
100000000000N000000000001
1000000000000000000000001
1111111111111111111111111

