NO ./textures/wolfenstein/grey_stone.xpm   
                 SO ./textures/wolfenstein/grey_stone.xpm
          WE ./textures/wolfenstein/grey_stone.xpm
EA             ./textures/wolfenstein/grey_stone.xpm

C 1,   85  ,32
F 220, 255, 200


1111111111111111111111111
1001000000000011000000001
1E00001000000000000000001
1000000000000000000000001
101
1111111111111111111111111