NO ./image.png    
SO ./image.png
WE ./image.png
EA ./image.png
C 0, 25, 50
F 220, 255,0



1111111   1111111111111   11111      
100000000011000000000000111                  
10110000011100000000000011
1001000000000000000000011
111111111011000001110000000000001
100000000011000001110111111111111
11110111111111011100000010001
11110111111111011101010010001
11000000110101011100000010001
10000000000000001100000010001
10000000000000001101010010001
11000001110101011111011110N0111
11110111 1110101 101111010001
11111111 1111111 111111111111